NO ./sprites/doom/wall1.png
EA ./sprites/doom/wall2.png
SO ./sprites/doom/wall3.png
WE ./sprites/doom/wall4.png


F 75,80,60
C 110,0,0

111111111111
100000000001
100000000001
101000N00011
101000000001
100000111001
1000001 1001
100000111001
100100000001
100010000111
100000000001
111111111111