NO ./sprites/doom/wall1.png
EA ./sprites/doom/wall2.png
SO ./sprites/doom/wall3.png
WE ./sprites/doom/wall4.png

F 75,80,60

C 110,0,0

1111111111111111111111111111111111111
100000000000000000100000000000000000111
101111111101011110101011101111111110001
101  100010000010010101 101       11101
10111100010111011000101 101         101
100000000101 1010011101 101111111111101
11111111110111010110001 100000000000001
         100100101001111101111111011111
    11111100001101011   101     101
    10000001101001001111101     1011111
    10111111100011100000001     1000001
    100001  101111111101111   111111111
    111101  1000001  101      101
       101111011101  101111111101
       10000001 10111100000000001
       11111101110000001111101111
            101 10111100010001
            1011101  111000111
            100000111100010001
            1111101  101111101
                10111101   101
                10000001   1N1
                11111111   111
